01000000111111111111
01111110111111111111
00000000111111111111
11101110001111111111
10000001100000000111
10111101111110110111
10100000000110110001
10111111110111111111
10111111110111111111
00111111110111111111
11111111110000000000
11111111111110111111
11111111111110111111
00000000001110111111
11101111101110111111
11101111100000100111
11101111111111101111
11100000000000000001
11111111111111101111
00000000000000001111