010000000111111111111
011111110111111111111
000000000111111111111
111101110011111111111
110001101100000000111
110111101111110110111
010100000000110110000
010111111110111111110
010111111110111111110
00011111110111111110
011111111110000000000
011111111111110111111
011111111111110111111
000000000001110111111
011101111101110111110
011101111100000100110
011101111111111101110
011100000000000000000
011111111111111101111
000000000000000001111