01000000111111111111
01111110111111111101
00000000111111111101
11011111100111111101
10011111100000000001
10111001111110110111
10100000000000110111
10111111110111110111
10111101110111110111
00111101110111110111
01111101110000110000
01111101111110111111
01111101111110111111
00000003001110111111
11101111101110111111
11101111100000100111
11101111111111101111
11100000000000000001
11111111111111101111
00000000000000001111
4,16,ugottriked 4,13,3 4,11,(10.13)